Layer5 8
62,17 65,17 86,23 59,17 80,17 56,23 83,17 77,17
Layer11 2
74,43 56,43
Layer6 6
86,83 84,83 80,83 82,83 76,83 78,83
Layer9 12
32,25 12,25 36,25 36,28 40,28 12,28 16,25 32,28 20,28 20,25 16,28 40,25
Layer10 271
12,59 12,60 12,61 12,62 12,63 12,64 12,65 12,66 12,67 12,68 12,69 12,70 12,71 12,72 12,73 12,74 12,75 12,76 12,77 12,78 12,79 12,80 12,81 12,82 12,83 12,84 12,85 12,86 12,87 13,87 14,87 15,87 16,87 17,87 18,87 19,87 20,87 21,87 22,87 23,87 24,87 25,87 26,87 27,87 28,87 29,87 30,87 31,87 32,87 33,87 34,87 35,87 36,87 37,87 38,87 39,87 40,87 41,87 42,87 42,75 42,76 42,77 42,78 42,79 42,80 42,81 42,82 42,83 42,84 42,85 42,86 42,57 42,58 42,59 42,60 42,61 42,62 42,63 42,64 42,65 42,66 42,67 42,68 42,69 21,57 22,57 23,57 24,57 25,57 26,57 27,57 28,57 29,57 30,57 31,57 32,57 33,57 34,57 35,57 36,57 37,57 38,57 39,57 40,57 41,57 16,71 17,61 21,78 40,60 16,70 38,86 29,84 24,75 22,86 34,60 37,66 40,76 17,64 25,70 23,80 15,75 36,71 20,71 34,61 16,64 34,62 18,61 14,65 14,64 40,70 39,83 20,72 20,78 22,80 34,75 23,78 15,70 15,73 18,68 25,62 38,67 30,68 18,82 28,74 18,67 25,63 25,83 18,66 34,83 32,71 30,70 15,64 25,84 21,61 27,84 36,86 14,84 33,86 25,67 38,66 37,86 37,60 18,64 20,74 35,75 22,78 20,73 16,83 18,65 32,81 38,71 39,85 24,77 15,74 33,71 22,61 33,81 25,61 36,75 37,75 38,63 22,82 19,69 32,62 40,75 30,74 24,80 25,60 25,65 39,75 16,72 30,71 36,67 14,86 30,73 14,85 26,74 26,84 38,60 20,81 25,68 21,85 18,69 14,66 22,81 35,60 40,69 15,76 31,71 34,82 23,77 31,64 21,82 25,59 20,79 34,71 20,82 25,74 30,81 15,72 40,62 35,71 39,60 19,61 34,81 39,86 33,62 39,84 24,76 25,72 37,67 30,69 28,84 16,82 38,65 17,82 29,83 16,84 22,85 30,67 40,67 31,62 20,69 37,71 33,75 25,64 34,86 36,60 40,68 40,61 15,84 29,82 20,80 20,77 27,74 24,74 25,66 15,69 29,81 29,74 31,81 38,75 38,64 25,69 31,63 36,66 34,84 20,70 25,71 39,67 20,61
Layer19 9
63,64 76,61 64,63 63,63 63,62 81,61 62,63 77,61 80,61
goc_2 12
35,61 31,63 37,63 29,65 35,71 31,73 27,77 31,79 29,81 37,81 17,83 39,83
goc_1 16
44,51 40,61 38,63 18,65 14,69 20,69 24,69 18,73 22,73 18,77 24,77 18,81 34,81 40,81 32,83 22,85
down 253
11,11 12,11 13,11 14,11 15,11 16,11 17,11 18,11 19,11 20,11 21,11 22,11 23,11 24,11 25,11 26,11 27,11 28,11 29,11 30,11 31,11 32,11 33,11 34,11 35,11 36,11 37,11 38,11 39,11 40,11 41,11 42,11 43,11 56,11 57,11 58,11 59,11 60,11 61,11 62,11 63,11 64,11 65,11 66,11 67,11 68,11 69,11 70,11 71,11 72,11 73,11 74,11 75,11 76,11 77,11 78,11 79,11 80,11 81,11 82,11 83,11 84,11 85,11 86,11 87,11 88,11 44,29 45,29 46,29 47,29 48,29 49,29 50,29 51,29 52,29 53,29 54,29 55,29 45,54 46,54 47,54 48,54 49,54 50,54 51,54 52,54 53,54 54,54 11,55 12,55 13,55 14,55 15,55 16,55 17,55 18,55 19,55 20,55 21,55 22,55 23,55 24,55 25,55 26,55 27,55 28,55 29,55 30,55 31,55 32,55 33,55 34,55 35,55 36,55 37,55 38,55 39,55 40,55 41,55 42,55 43,55 56,55 57,55 58,55 59,55 60,55 61,55 62,55 63,55 64,55 65,55 66,55 67,55 68,55 69,55 75,55 76,55 77,55 78,55 79,55 80,55 81,55 82,55 83,55 84,55 85,55 86,55 87,55 88,55 13,56 14,56 15,56 16,56 17,56 18,56 19,56 20,56 21,56 22,56 23,56 24,56 25,56 26,56 27,56 28,56 29,56 30,56 31,56 32,56 33,56 34,56 35,56 36,56 37,56 38,56 39,56 40,56 41,56 42,56 13,58 14,58 15,58 16,58 17,58 18,58 23,58 24,58 27,58 28,58 29,58 30,58 33,58 34,58 35,58 36,58 41,58 42,58 13,60 14,60 17,60 18,60 19,60 20,60 21,60 22,60 27,60 28,60 29,60 30,60 23,64 24,64 25,64 26,64 35,64 36,64 39,64 40,64 31,66 32,66 27,68 28,68 37,72 38,72 33,74 34,74 35,74 36,74 37,74 38,74 39,74 40,74 44,74 45,74 46,74 47,74 48,74 49,74 50,74 51,74 52,74 53,74 54,74 55,74 25,78 26,78 41,78 42,78 25,84 26,84 27,84 28,84 35,84 36,84
up 323
44,25 45,25 46,25 47,25 48,25 49,25 50,25 51,25 52,25 53,25 54,25 55,25 11,44 12,44 13,44 14,44 15,44 16,44 17,44 18,44 19,44 20,44 21,44 22,44 23,44 24,44 30,44 31,44 32,44 33,44 34,44 35,44 36,44 37,44 38,44 39,44 40,44 41,44 42,44 43,44 56,44 57,44 58,44 59,44 60,44 61,44 62,44 63,44 64,44 65,44 66,44 67,44 68,44 69,44 75,44 76,44 77,44 78,44 79,44 80,44 81,44 82,44 83,44 84,44 85,44 86,44 87,44 88,44 45,45 46,45 47,45 48,45 49,45 50,45 51,45 52,45 53,45 54,45 30,48 31,48 32,48 33,48 34,48 35,48 36,48 37,48 38,48 39,48 40,48 41,48 42,48 43,48 44,48 25,51 26,51 27,51 28,51 29,51 30,51 31,51 32,51 33,51 34,51 35,51 36,51 37,51 38,51 39,51 40,51 41,51 42,51 43,51 36,61 37,61 38,61 39,61 15,63 16,63 17,63 18,63 19,63 20,63 25,63 26,63 27,63 28,63 32,63 33,63 34,63 15,65 16,65 17,65 30,65 31,65 32,65 37,67 38,67 39,67 40,67 13,69 19,69 23,69 33,69 34,69 35,69 36,69 37,69 38,69 44,70 45,70 46,70 47,70 48,70 49,70 50,70 51,70 52,70 53,70 54,70 55,70 15,71 16,71 31,71 32,71 33,71 34,71 36,71 37,71 38,71 15,73 16,73 17,73 21,73 25,73 26,73 27,73 28,73 32,73 33,73 34,73 25,75 26,75 27,75 28,75 29,75 30,75 17,77 23,77 28,77 31,77 32,77 33,77 34,77 35,77 36,77 15,79 16,79 21,79 22,79 32,79 33,79 34,79 35,79 36,79 37,79 38,79 15,81 16,81 17,81 23,81 24,81 30,81 31,81 32,81 33,81 38,81 39,81 13,83 14,83 18,83 21,83 22,83 31,83 40,83 15,85 16,85 21,85 13,87 14,87 15,87 16,87 17,87 18,87 19,87 20,87 21,87 22,87 23,87 24,87 25,87 26,87 27,87 28,87 29,87 30,87 31,87 32,87 33,87 34,87 35,87 36,87 37,87 38,87 39,87 40,87 41,87 42,87 11,89 12,89 13,89 14,89 15,89 16,89 17,89 18,89 19,89 20,89 21,89 22,89 23,89 24,89 25,89 26,89 27,89 28,89 29,89 30,89 31,89 32,89 33,89 34,89 35,89 36,89 37,89 38,89 39,89 40,89 41,89 42,89 43,89 56,89 57,89 58,89 59,89 60,89 61,89 62,89 63,89 64,89 65,89 66,89 67,89 68,89 69,89 70,89 71,89 72,89 73,89 74,89 75,89 76,89 77,89 78,89 79,89 80,89 81,89 82,89 83,89 84,89 85,89 86,89 87,89 88,89
left 236
44,12 89,12 44,13 89,13 44,14 89,14 44,15 89,15 44,16 89,16 44,17 89,17 44,18 89,18 44,19 89,19 44,20 89,20 44,21 89,21 44,22 89,22 44,23 89,23 44,24 89,24 89,25 89,26 89,27 89,28 89,29 44,30 89,30 44,31 89,31 44,32 89,32 44,33 89,33 44,34 89,34 44,35 89,35 44,36 89,36 44,37 89,37 44,38 89,38 44,39 89,39 44,40 89,40 44,41 89,41 44,42 89,42 44,43 89,43 25,44 70,44 25,45 55,45 70,45 25,46 55,46 70,46 25,47 55,47 70,47 25,48 55,48 70,48 25,49 55,49 70,49 25,50 55,50 70,50 55,51 70,51 55,52 70,52 55,53 70,53 55,54 70,54 70,55 44,56 89,56 43,57 44,57 89,57 43,58 44,58 89,58 31,59 39,59 43,59 44,59 89,59 31,60 39,60 43,60 44,60 89,60 43,61 44,61 89,61 35,62 43,62 44,62 89,62 21,63 29,63 43,63 44,63 89,63 21,64 29,64 31,64 37,64 43,64 44,64 89,64 21,65 33,65 35,65 43,65 44,65 89,65 21,66 29,66 33,66 35,66 43,66 44,66 89,66 35,67 41,67 43,67 44,67 89,67 35,68 41,68 43,68 44,68 89,68 17,69 29,69 41,69 43,69 44,69 89,69 17,70 29,70 41,70 89,70 17,71 29,71 39,71 89,71 17,72 29,72 35,72 39,72 89,72 89,73 31,74 89,74 31,75 35,75 41,75 43,75 44,75 89,75 31,76 35,76 41,76 43,76 44,76 89,76 29,77 39,77 43,77 44,77 89,77 27,78 29,78 39,78 43,78 44,78 89,78 27,79 43,79 44,79 89,79 27,80 31,80 43,80 44,80 89,80 27,81 43,81 44,81 89,81 27,82 29,82 37,82 43,82 44,82 89,82 29,83 37,83 43,83 44,83 89,83 17,84 29,84 37,84 39,84 43,84 44,84 89,84 39,85 43,85 44,85 89,85 39,86 43,86 44,86 89,86 44,87 89,87 44,88 89,88
right 263
10,12 55,12 10,13 55,13 10,14 55,14 10,15 55,15 10,16 55,16 10,17 55,17 10,18 55,18 10,19 55,19 10,20 55,20 10,21 55,21 10,22 55,22 10,23 55,23 10,24 55,24 10,25 10,26 10,27 10,28 10,29 10,30 55,30 10,31 55,31 10,32 55,32 10,33 55,33 10,34 55,34 10,35 55,35 10,36 55,36 10,37 55,37 10,38 55,38 10,39 55,39 10,40 55,40 10,41 55,41 10,42 55,42 10,43 55,43 29,44 74,44 29,45 44,45 74,45 29,46 44,46 74,46 29,47 44,47 74,47 74,48 74,49 74,50 74,51 44,52 74,52 44,53 74,53 44,54 74,54 74,55 10,56 55,56 10,57 20,57 26,57 55,57 10,58 20,58 26,58 55,58 10,59 12,59 24,59 32,59 55,59 10,60 12,60 24,60 32,60 55,60 10,61 12,61 14,61 24,61 26,61 32,61 55,61 10,62 12,62 14,62 24,62 26,62 32,62 40,62 55,62 10,63 12,63 55,63 10,64 12,64 38,64 55,64 10,65 12,65 14,65 24,65 38,65 55,65 10,66 12,66 14,66 18,66 24,66 38,66 55,66 10,67 12,67 18,67 22,67 24,67 26,67 30,67 55,67 10,68 12,68 18,68 22,68 24,68 26,68 30,68 55,68 10,69 12,69 18,69 22,69 26,69 30,69 55,69 10,70 12,70 14,70 18,70 20,70 22,70 24,70 26,70 30,70 10,71 12,71 20,71 24,71 10,72 12,72 20,72 24,72 10,73 12,73 14,73 20,73 10,74 12,74 14,74 18,74 20,74 22,74 10,75 12,75 14,75 16,75 18,75 24,75 55,75 10,76 12,76 14,76 16,76 18,76 24,76 55,76 10,77 12,77 16,77 20,77 22,77 55,77 10,78 12,78 16,78 18,78 20,78 22,78 24,78 55,78 10,79 12,79 20,79 55,79 10,80 12,80 20,80 55,80 10,81 12,81 20,81 22,81 55,81 10,82 12,82 18,82 20,82 22,82 34,82 40,82 55,82 10,83 12,83 24,83 34,83 55,83 10,84 12,84 24,84 32,84 34,84 55,84 10,85 12,85 14,85 18,85 32,85 55,85 10,86 12,86 14,86 18,86 22,86 32,86 55,86 10,87 55,87 10,88 55,88
Layer12 2
65,34 65,20
Layer13 1
65,21
Layer13_1 1
79,21
Layer8 1
82,68
Layer14 2
66,21 73,28
Layer15 2
73,21 66,28
Layer16 1
75,56
Layer20 1
75,64
Layer21 1
88,57
Layer22 1
75,57
Layer23 1
81,65
Layer24 1
81,75
Layer25 1
81,73
Layer6 38
42,36 13,31 11,31 84,83 11,36 76,83 86,83 34,31 19,31 30,42 36,31 40,31 23,42 15,31 15,36 19,36 30,31 38,31 17,31 23,36 23,31 32,31 80,83 19,42 42,42 38,36 34,36 78,83 15,42 76,62 34,42 38,42 78,62 30,36 82,83 42,31 21,31 11,42
Layer27 26
80,12 83,12 59,12 56,32 65,12 86,12 86,32 56,12 62,12 77,12 86,34 56,34 56,14 86,14 56,18 56,38 68,38 86,38 62,38 65,38 77,38 80,38 83,38 74,38 86,18 59,38
***
Layer1 12
83,77 57,63 57,56 64,56 38,17 17,17 38,12 33,12 12,12 33,17 12,17 17,12
Layer2 1
67,5
Layer3 21
65,77 31,37 20,31 16,37 57,77 31,31 57,83 35,37 16,31 35,31 12,37 20,37 12,31 84,83 76,83 61,77 39,37 79,83 65,83 61,83 39,31
Layer4 1
22,11
Layer6 30
11,59 27,87 19,87 11,85 13,87 41,87 15,87 21,87 37,87 11,75 33,87 11,73 39,87 11,63 11,79 23,87 35,87 25,87 11,87 11,67 11,77 11,83 11,69 11,71 17,87 11,81 11,61 29,87 31,87 11,65
Layer7 1
76,77
Layer8 2
82,68 76,55
Layer6 44
64,81 87,67 41,21 24,20 82,73 64,87 37,21 62,58 75,87 56,81 12,16 76,62 68,81 16,16 33,16 68,87 62,56 83,87 60,60 60,67 16,21 37,16 87,87 60,87 79,87 78,62 67,60 57,60 57,67 60,81 33,21 86,81 81,65 83,81 64,60 41,16 56,87 20,21 86,73 12,21 87,65 29,20 81,67 20,16
Layer27 2
82,55 85,55