Layer5 8
62,17 65,17 86,23 59,17 80,17 56,23 83,17 77,17
Layer11 2
74,43 56,43
Layer6 6
86,83 84,83 80,83 82,83 76,83 78,83
Layer9 12
32,25 12,25 36,25 36,28 40,28 12,28 16,25 32,28 20,28 20,25 16,28 40,25
Layer10 271
12,59 12,60 12,61 12,62 12,63 12,64 12,65 12,66 12,67 12,68 12,69 12,70 12,71 12,72 12,73 12,74 12,75 12,76 12,77 12,78 12,79 12,80 12,81 12,82 12,83 12,84 12,85 12,86 12,87 13,87 14,87 15,87 16,87 17,87 18,87 19,87 20,87 21,87 22,87 23,87 24,87 25,87 26,87 27,87 28,87 29,87 30,87 31,87 32,87 33,87 34,87 35,87 36,87 37,87 38,87 39,87 40,87 41,87 42,87 42,75 42,76 42,77 42,78 42,79 42,80 42,81 42,82 42,83 42,84 42,85 42,86 42,57 42,58 42,59 42,60 42,61 42,62 42,63 42,64 42,65 42,66 42,67 42,68 42,69 21,57 22,57 23,57 24,57 25,57 26,57 27,57 28,57 29,57 30,57 31,57 32,57 33,57 34,57 35,57 36,57 37,57 38,57 39,57 40,57 41,57 16,71 17,61 21,78 40,60 16,70 38,86 29,84 24,75 22,86 34,60 37,66 40,76 17,64 25,70 23,80 15,75 36,71 20,71 34,61 16,64 34,62 18,61 14,65 14,64 40,70 39,83 20,72 20,78 22,80 34,75 23,78 15,70 15,73 18,68 25,62 38,67 30,68 18,82 28,74 18,67 25,63 25,83 18,66 34,83 32,71 30,70 15,64 25,84 21,61 27,84 36,86 14,84 33,86 25,67 38,66 37,86 37,60 18,64 20,74 35,75 22,78 20,73 16,83 18,65 32,81 38,71 39,85 24,77 15,74 33,71 22,61 33,81 25,61 36,75 37,75 38,63 22,82 19,69 32,62 40,75 30,74 24,80 25,60 25,65 39,75 16,72 30,71 36,67 14,86 30,73 14,85 26,74 26,84 38,60 20,81 25,68 21,85 18,69 14,66 22,81 35,60 40,69 15,76 31,71 34,82 23,77 31,64 21,82 25,59 20,79 34,71 20,82 25,74 30,81 15,72 40,62 35,71 39,60 19,61 34,81 39,86 33,62 39,84 24,76 25,72 37,67 30,69 28,84 16,82 38,65 17,82 29,83 16,84 22,85 30,67 40,67 31,62 20,69 37,71 33,75 25,64 34,86 36,60 40,68 40,61 15,84 29,82 20,80 20,77 27,74 24,74 25,66 15,69 29,81 29,74 31,81 38,75 38,64 25,69 31,63 36,66 34,84 20,70 25,71 39,67 20,61
***
Layer1 12
83,77 57,63 57,56 64,56 38,17 17,17 38,12 33,12 12,12 33,17 12,17 17,12
Layer2 1
67,5
Layer3 21
65,77 31,37 20,31 16,37 57,77 31,31 57,83 35,37 16,31 35,31 12,37 20,37 12,31 84,83 76,83 61,77 39,37 79,83 65,83 61,83 39,31
Layer4 1
22,11
Layer6 30
11,59 27,87 19,87 11,85 13,87 41,87 15,87 21,87 37,87 11,75 33,87 11,73 39,87 11,63 11,79 23,87 35,87 25,87 11,87 11,67 11,77 11,83 11,69 11,71 17,87 11,81 11,61 29,87 31,87 11,65
Layer7 1
76,77
Layer8 2
82,68 76,55