Map02 1
0,0
Shadow1 1
12,25
Shadow2 1
56,17
Shadow3 1
62,61
Shadow4 1
12,57
Fence1 1
10,11
Fence2 1
50,11
Fence3 1
50,50
Fence4 1
10,50
Layer6 6
86,83 84,83 80,83 82,83 76,83 78,83
Layer12 2
65,34 65,20
Layer13 1
65,21
Layer17 1
79,21
Layer8 1
82,68
Layer16 1
75,56
Layer20 1
75,64
Layer21 1
88,57
Layer22 1
75,57
Layer23 1
81,65
Layer24 1
81,75
Layer25 1
81,73
Layer6 30
13,31 11,31 84,83 76,83 86,83 34,31 19,31 30,42 36,31 40,31 23,42 15,31 30,31 38,31 17,31 23,31 32,31 80,83 19,42 42,42 78,83 15,42 76,62 34,42 38,42 78,62 82,83 42,31 21,31 11,42
Layer27 26
80,12 83,12 59,12 56,32 65,12 86,12 86,32 56,12 62,12 77,12 86,34 56,34 56,14 86,14 56,18 56,38 68,38 86,38 62,38 65,38 77,38 80,38 83,38 74,38 86,18 59,38
***
Layer1 12
83,77 57,63 57,56 64,56 38,17 17,17 38,12 33,12 12,12 33,17 12,17 17,12
Layer2 1
67,5
Layer3 21
65,77 31,37 20,31 16,37 57,77 31,31 57,83 35,37 16,31 35,31 12,37 20,37 12,31 84,83 76,83 61,77 39,37 79,83 65,83 61,83 39,31
Layer4 1
22,11
Layer6 30
11,59 27,87 19,87 11,85 13,87 41,87 15,87 21,87 37,87 11,75 33,87 11,73 39,87 11,63 11,79 23,87 35,87 25,87 11,87 11,67 11,77 11,83 11,69 11,71 17,87 11,81 11,61 29,87 31,87 11,65
Layer7 1
76,77
Layer8 2
82,68 76,55
Layer6 44
64,81 87,67 41,21 24,20 82,73 64,87 37,21 62,58 75,87 56,81 12,16 76,62 68,81 16,16 33,16 68,87 62,56 83,87 60,60 60,67 16,21 37,16 87,87 60,87 79,87 78,62 67,60 57,60 57,67 60,81 33,21 86,81 81,65 83,81 64,60 41,16 56,87 20,21 86,73 12,21 87,65 29,20 81,67 20,16
Layer27 2
82,55 85,55