1 1 1 1 1 1 1 1 1 1 1 1 1 1 1 1 1 1 1 1 1 1 1 1 1 1 1 1 1 1 1 1 1 1 1 1 1 1 1 1 1 1 1 1 1 1 1 1 1 1 1 1 1 1 1 1 1 1 1 1 1 1 1 1 1 1 1 1 1 1 1 1 1 1 1 1 1 1 1 1 1 1 1 1 1 1 1 1 1 1 1 1 1 1 1 1 1 1 1 1
1 1 1 1 1 1 1 1 1 1 1 1 1 1 1 1 1 1 1 1 1 1 1 1 1 1 1 1 1 1 1 1 1 1 1 1 1 1 1 1 1 1 1 1 1 1 1 1 1 1 1 1 1 1 1 1 1 1 1 1 1 1 1 1 1 1 1 1 1 1 1 1 1 1 1 1 1 1 1 1 1 1 1 1 1 1 1 1 1 1 1 1 1 1 1 1 1 1 1 1
1 1 1 1 1 1 1 1 1 1 1 1 1 1 1 1 1 1 1 1 1 1 1 1 1 1 1 1 1 1 1 1 1 1 1 1 1 1 1 1 1 1 1 1 1 1 1 1 1 1 1 1 1 1 1 1 1 1 1 1 1 1 1 1 1 1 1 1 1 1 1 1 1 1 1 1 1 1 1 1 1 1 1 1 1 1 1 1 1 1 1 1 1 1 1 1 1 1 1 1
1 1 1 1 1 1 1 1 1 1 1 1 1 1 1 1 1 1 1 1 1 1 1 1 1 1 1 1 1 1 1 1 1 1 1 1 1 1 1 1 1 1 1 1 1 1 1 1 1 1 1 1 1 1 1 1 1 1 1 1 1 1 1 1 1 1 1 1 1 1 1 1 1 1 1 1 1 1 1 1 1 1 1 1 1 1 1 1 1 1 1 1 1 1 1 1 1 1 1 1
1 1 1 1 1 1 1 1 1 1 1 1 1 1 1 1 1 1 1 1 1 1 1 1 1 1 1 1 1 1 1 1 1 1 1 1 1 1 1 1 1 1 1 1 1 1 1 1 1 1 1 1 1 1 1 1 1 1 1 1 1 1 1 1 1 1 1 1 1 1 1 1 1 1 1 1 1 1 1 1 1 1 1 1 1 1 1 1 1 1 1 1 1 1 1 1 1 1 1 1
1 1 1 1 1 1 1 1 1 1 1 1 1 1 1 1 1 1 1 1 1 1 1 1 1 1 1 1 1 1 1 1 1 1 1 1 1 1 1 1 1 1 1 1 1 1 1 1 1 1 1 1 1 1 1 1 1 1 1 1 1 1 1 1 1 1 1 1 1 1 1 1 1 1 1 1 1 1 1 1 1 1 1 1 1 1 1 1 1 1 1 1 1 1 1 1 1 1 1 1
1 1 1 1 1 1 1 1 1 1 1 1 1 1 1 1 1 1 1 1 1 1 1 1 1 1 1 1 1 1 1 1 1 1 1 1 1 1 1 1 1 1 1 1 1 1 1 1 1 1 1 1 1 1 1 1 1 1 1 1 1 1 1 1 1 1 1 1 1 1 1 1 1 1 1 1 1 1 1 1 1 1 1 1 1 1 1 1 1 1 1 1 1 1 1 1 1 1 1 1
1 1 1 1 1 1 1 1 1 1 1 1 1 1 1 1 1 1 1 1 1 1 1 1 1 1 1 1 1 1 1 1 1 1 1 1 1 1 1 1 1 1 1 1 1 1 1 1 1 1 1 1 1 1 1 1 1 1 1 1 1 1 1 1 1 1 1 1 1 1 1 1 1 1 1 1 1 1 1 1 1 1 1 1 1 1 1 1 1 1 1 1 1 1 1 1 1 1 1 1
1 1 1 1 1 1 1 1 1 1 1 1 1 1 1 1 1 1 1 1 1 1 1 1 1 1 1 1 1 1 1 1 1 1 1 1 1 1 1 1 1 1 1 1 1 1 1 1 1 1 1 1 1 1 1 1 1 1 1 1 1 1 1 1 1 1 1 1 1 1 1 1 1 1 1 1 1 1 1 1 1 1 1 1 1 1 1 1 1 1 1 1 1 1 1 1 1 1 1 1
1 1 1 1 1 1 1 1 1 1 1 1 1 1 1 1 1 1 1 1 1 1 1 1 1 1 1 1 1 1 1 1 1 1 1 1 1 1 1 1 1 1 1 1 1 1 1 1 1 1 1 1 1 1 1 1 1 1 1 1 1 1 1 1 1 1 1 1 1 1 1 1 1 1 1 1 1 1 1 1 1 1 1 1 1 1 1 1 1 1 1 1 1 1 1 1 1 1 1 1
1 1 1 1 1 1 1 1 1 2 6 6 6 6 6 6 6 6 6 6 6 6 6 6 6 6 6 6 6 6 6 6 6 6 6 6 6 6 6 6 6 6 6 6 6 3 1 1 1 1 1 1 1 1 2 6 6 6 6 6 6 6 6 6 6 6 6 6 6 6 6 6 6 6 6 6 6 6 6 6 6 6 6 6 6 6 6 6 6 6 3 1 1 1 1 1 1 1 1 1
1 1 1 1 1 1 1 1 1 7 11 11 11 11 11 11 11 11 11 11 11 11 11 11 11 11 11 11 11 11 11 11 11 11 11 11 11 11 11 11 11 11 11 11 11 8 1 1 1 1 1 1 1 1 7 11 11 11 11 11 11 11 11 11 11 11 11 11 11 11 11 11 11 11 11 11 11 11 11 11 11 11 11 11 11 11 11 11 11 11 8 1 1 1 1 1 1 1 1 1
1 1 1 1 1 1 1 1 1 7 11 12 21 21 21 21 21 21 21 21 21 21 21 21 21 21 21 21 21 21 21 21 21 21 21 21 21 21 21 21 21 21 21 13 11 8 1 1 1 1 1 1 1 1 7 11 17 17 17 17 17 17 17 17 17 17 17 17 17 17 17 17 17 17 17 17 17 17 17 17 17 17 17 17 17 17 17 17 17 11 8 1 1 1 1 1 1 1 1 1
1 1 1 1 1 1 1 1 1 7 11 18 16 16 16 16 16 16 16 16 16 16 16 16 16 16 16 16 16 16 16 16 16 16 16 16 16 16 16 16 16 16 16 20 11 8 1 1 1 1 1 1 1 1 7 11 17 17 17 17 17 17 17 17 17 17 17 17 17 17 17 17 17 17 17 17 17 17 17 17 17 17 17 17 17 17 17 17 17 11 8 1 1 1 1 1 1 1 1 1
1 1 1 1 1 1 1 1 1 7 11 18 16 16 16 16 16 16 16 16 16 16 16 16 16 16 16 16 16 16 16 16 16 16 16 16 16 16 16 16 16 16 16 20 11 8 1 1 1 1 1 1 1 1 7 11 17 17 17 17 17 17 17 17 17 17 17 17 17 17 17 17 17 17 17 17 17 17 17 17 17 17 17 17 17 17 17 17 17 11 8 1 1 1 1 1 1 1 1 1
1 1 1 1 1 1 1 1 1 7 11 18 16 16 16 16 16 16 16 16 16 16 16 16 16 16 16 16 16 16 16 16 16 16 16 16 16 16 16 16 16 16 16 20 11 8 1 1 1 1 1 1 1 1 7 11 17 17 17 17 12 21 21 21 21 21 21 21 21 21 21 21 21 21 21 21 21 21 21 21 21 21 21 21 13 17 17 17 17 11 8 1 1 1 1 1 1 1 1 1
1 1 1 1 1 1 1 1 1 7 11 18 16 16 16 16 16 16 16 16 16 16 16 16 16 16 16 16 16 16 16 16 16 16 16 16 16 16 16 16 16 16 16 20 11 8 1 1 1 1 1 1 1 1 7 11 17 17 17 17 18 16 16 16 16 16 16 16 16 16 16 16 16 16 16 16 16 16 16 16 16 16 16 16 20 17 17 17 17 11 8 1 1 1 1 1 1 1 1 1
1 1 1 1 1 1 1 1 1 7 11 18 16 16 16 16 16 16 16 16 16 16 16 16 16 16 16 16 16 16 16 16 16 16 16 16 16 16 16 16 16 16 16 20 11 8 1 1 1 1 1 1 1 1 7 11 17 17 17 17 18 16 16 16 16 16 16 16 16 16 16 16 16 16 16 16 16 16 16 16 16 16 16 16 20 17 17 17 17 11 8 1 1 1 1 1 1 1 1 1
1 1 1 1 1 1 1 1 1 7 11 18 16 16 16 16 16 16 16 16 16 16 16 16 16 16 16 16 16 16 16 16 16 16 16 16 16 16 16 16 16 16 16 20 11 8 1 1 1 1 1 1 1 1 7 11 17 17 17 17 18 16 16 16 16 16 16 16 16 16 16 16 16 16 16 16 16 16 16 16 16 16 16 16 20 17 17 17 17 11 8 1 1 1 1 1 1 1 1 1
1 1 1 1 1 1 1 1 1 7 11 18 16 16 16 16 16 16 16 16 16 16 16 16 16 16 16 16 16 16 16 16 16 16 16 16 16 16 16 16 16 16 16 20 11 8 1 1 1 1 1 1 1 1 7 11 17 17 17 17 18 16 16 16 16 16 16 16 16 16 16 16 16 16 16 16 16 16 16 16 16 16 16 16 20 17 17 17 17 11 8 1 1 1 1 1 1 1 1 1
1 1 1 1 1 1 1 1 1 7 11 18 16 16 16 16 16 16 16 16 16 16 16 16 16 16 16 16 16 16 16 16 16 16 16 16 16 16 16 16 16 16 16 20 11 8 1 1 1 1 1 1 1 1 7 11 17 17 17 17 18 16 16 16 16 16 16 16 16 16 16 16 16 16 16 16 16 16 16 16 16 16 16 16 20 17 17 17 17 11 8 1 1 1 1 1 1 1 1 1
1 1 1 1 1 1 1 1 1 7 11 18 16 16 16 16 16 16 16 16 16 16 16 16 16 16 16 16 16 16 16 16 16 16 16 16 16 16 16 16 16 16 16 20 11 8 1 1 1 1 1 1 1 1 7 11 17 17 17 17 18 16 16 16 16 16 17 17 17 17 17 17 16 17 17 17 17 17 17 16 16 16 16 16 20 17 17 17 17 11 8 1 1 1 1 1 1 1 1 1
1 1 1 1 1 1 1 1 1 7 11 18 16 16 16 16 16 16 16 16 16 16 16 16 16 16 16 16 16 16 16 16 16 16 16 16 16 16 16 16 16 16 16 20 11 8 1 1 1 1 1 1 1 1 7 11 17 17 17 17 18 16 16 16 16 16 17 17 17 17 17 17 16 17 17 17 17 17 17 16 16 16 16 16 20 17 17 17 17 11 8 1 1 1 1 1 1 1 1 1
1 1 1 1 1 1 1 1 1 7 11 14 19 19 19 19 19 19 19 19 19 19 23 16 16 16 16 16 16 16 16 16 22 19 19 19 19 19 19 19 19 19 19 15 11 8 1 1 1 1 1 1 1 1 7 11 17 17 17 17 18 16 16 16 16 16 17 17 17 17 17 17 16 17 17 17 17 17 17 16 16 16 16 16 20 17 17 17 17 11 8 1 1 1 1 1 1 1 1 1
1 1 1 1 1 1 1 1 1 7 11 12 21 21 21 21 21 21 21 21 21 21 25 16 16 16 16 16 16 16 16 16 24 21 21 21 21 21 21 21 21 21 21 13 11 8 1 1 1 1 1 1 1 1 7 11 17 17 17 17 18 16 16 16 16 16 17 17 17 17 17 17 16 17 17 17 17 17 17 16 16 16 16 16 20 17 17 17 17 11 8 1 1 1 1 1 1 1 1 1
1 1 1 1 1 1 1 1 1 7 11 18 16 16 16 16 16 16 16 16 16 16 16 16 16 16 16 16 16 16 16 16 16 16 16 16 16 16 16 16 16 16 16 20 10 10 10 10 10 10 10 10 10 10 10 10 17 17 17 17 18 16 16 16 16 16 17 17 17 17 17 17 16 17 17 17 17 17 17 16 16 16 16 16 20 17 17 17 17 11 8 1 1 1 1 1 1 1 1 1
1 1 1 1 1 1 1 1 1 7 11 18 16 16 16 16 16 16 16 16 16 16 16 16 16 16 16 16 16 16 16 16 16 16 16 16 16 16 16 16 16 16 16 20 10 10 10 10 10 10 10 10 10 10 10 10 17 17 17 17 18 16 16 16 16 16 17 17 17 17 17 17 16 17 17 17 17 17 17 16 16 16 16 16 20 17 17 17 17 11 8 1 1 1 1 1 1 1 1 1
1 1 1 1 1 1 1 1 1 7 11 18 16 16 16 16 16 16 16 16 16 16 16 16 16 16 16 16 16 16 16 16 16 16 16 16 16 16 16 16 16 16 16 20 10 10 10 10 10 10 10 10 10 10 10 10 17 17 17 17 18 16 16 16 16 16 16 16 16 16 16 16 16 16 16 16 16 16 16 16 16 16 16 16 20 17 17 17 17 11 8 1 1 1 1 1 1 1 1 1
1 1 1 1 1 1 1 1 1 7 11 18 16 16 16 16 16 16 16 16 16 16 16 16 16 16 16 16 16 16 16 16 16 16 16 16 16 16 16 16 16 16 16 20 10 10 10 10 10 10 10 10 10 10 10 10 17 17 17 17 18 16 16 16 16 16 17 17 17 17 17 17 16 17 17 17 17 17 17 16 16 16 16 16 20 17 17 17 17 11 8 1 1 1 1 1 1 1 1 1
1 1 1 1 1 1 1 1 1 7 11 18 16 16 16 16 16 16 16 16 16 16 16 16 16 16 16 16 16 16 16 16 16 16 16 16 16 16 16 16 16 16 16 20 10 10 10 10 10 10 10 10 10 10 10 10 17 17 17 17 18 16 16 16 16 16 17 17 17 17 17 17 16 17 17 17 17 17 17 16 16 16 16 16 20 17 17 17 17 11 8 1 1 1 1 1 1 1 1 1
1 1 1 1 1 1 1 1 1 7 11 14 19 19 19 19 19 19 19 19 19 19 19 19 19 23 16 16 16 22 19 19 19 19 19 19 19 19 19 19 19 19 19 15 11 8 29 29 29 29 29 29 29 29 7 11 17 17 17 17 18 16 16 16 16 16 17 17 17 17 17 17 16 17 17 17 17 17 17 16 16 16 16 16 20 17 17 17 17 11 8 1 1 1 1 1 1 1 1 1
1 1 1 1 1 1 1 1 1 7 11 17 17 17 17 17 17 17 17 17 17 17 17 17 17 18 16 16 16 20 17 17 17 17 17 17 17 17 17 17 17 17 17 17 11 8 1 1 1 1 1 1 1 1 7 11 17 17 17 17 18 16 16 16 16 16 17 17 17 17 17 17 16 17 17 17 17 17 17 16 16 16 16 16 20 17 17 17 17 11 8 1 1 1 1 1 1 1 1 1
1 1 1 1 1 1 1 1 1 7 11 17 17 17 17 17 17 17 17 17 17 17 17 17 17 18 16 16 16 20 17 17 17 17 17 17 17 17 17 17 17 17 17 17 11 8 1 1 1 1 1 1 1 1 7 11 17 17 17 17 18 16 16 16 16 16 17 17 17 17 17 17 16 17 17 17 17 17 17 16 16 16 16 16 20 17 17 17 17 11 8 1 1 1 1 1 1 1 1 1
1 1 1 1 1 1 1 1 1 7 11 12 21 21 21 21 21 21 21 21 21 21 21 21 21 25 16 16 16 24 21 21 21 21 21 21 21 21 21 21 21 21 21 13 11 8 1 1 1 1 1 1 1 1 7 11 17 17 17 17 18 16 16 16 16 16 17 17 17 17 17 17 16 17 17 17 17 17 17 16 16 16 16 16 20 17 17 17 17 11 8 1 1 1 1 1 1 1 1 1
1 1 1 1 1 1 1 1 1 7 11 18 16 16 16 16 16 16 16 16 16 16 16 16 16 16 16 16 16 16 16 16 16 16 16 16 16 16 16 16 16 16 16 20 11 8 1 1 1 1 1 1 1 1 7 11 17 17 17 17 18 16 16 16 16 16 16 16 16 16 16 16 16 16 16 16 16 16 16 16 16 16 16 16 20 17 17 17 17 11 8 1 1 1 1 1 1 1 1 1
1 1 1 1 1 1 1 1 1 7 11 18 16 16 16 16 16 16 16 16 16 16 16 16 16 16 16 16 16 16 16 16 16 16 16 16 16 16 16 16 16 16 16 20 11 8 1 1 1 1 1 1 1 1 7 11 17 17 17 17 18 16 16 16 16 16 16 16 16 16 16 16 16 16 16 16 16 16 16 16 16 16 16 16 20 17 17 17 17 11 8 1 1 1 1 1 1 1 1 1
1 1 1 1 1 1 1 1 1 7 11 18 16 16 16 16 16 16 16 16 16 16 16 16 16 16 16 16 16 16 16 16 16 16 16 16 16 16 16 16 16 16 16 20 11 8 1 1 1 1 1 1 1 1 7 11 17 17 17 17 18 16 16 16 16 16 16 16 16 16 16 16 16 16 16 16 16 16 16 16 16 16 16 16 20 17 17 17 17 11 8 1 1 1 1 1 1 1 1 1
1 1 1 1 1 1 1 1 1 7 11 18 16 16 16 16 16 16 16 16 16 16 16 16 16 16 16 16 16 16 16 16 16 16 16 16 16 16 16 16 16 16 16 20 11 8 1 1 1 1 1 1 1 1 7 11 17 17 17 17 18 16 16 16 16 16 16 16 16 16 16 16 16 16 16 16 16 16 16 16 16 16 16 16 20 17 17 17 17 11 8 1 1 1 1 1 1 1 1 1
1 1 1 1 1 1 1 1 1 7 11 18 16 16 16 16 16 16 16 16 16 16 16 16 16 16 16 16 16 16 16 16 16 16 16 16 16 16 16 16 16 16 16 20 11 8 1 1 1 1 1 1 1 1 7 11 17 17 17 17 18 16 16 16 16 16 16 16 16 16 16 16 16 16 16 16 16 16 16 16 16 16 16 16 20 17 17 17 17 11 8 1 1 1 1 1 1 1 1 1
1 1 1 1 1 1 1 1 1 7 11 18 16 16 16 16 16 16 16 16 16 16 16 16 16 16 16 16 16 16 16 16 16 16 16 16 16 16 16 16 16 16 16 20 11 8 1 1 1 1 1 1 1 1 7 11 17 17 17 17 14 19 19 19 19 19 19 19 19 19 19 19 19 19 19 19 19 19 19 19 19 19 19 19 15 17 17 17 17 11 8 1 1 1 1 1 1 1 1 1
1 1 1 1 1 1 1 1 1 7 11 18 16 16 16 16 16 16 16 16 16 16 16 16 16 16 16 16 16 16 16 16 16 16 16 16 16 16 16 16 16 16 16 20 11 8 1 1 1 1 1 1 1 1 7 11 17 17 17 17 17 17 17 17 17 17 17 17 17 17 17 17 17 17 17 17 17 17 17 17 17 17 17 17 17 17 17 17 17 11 8 1 1 1 1 1 1 1 1 1
1 1 1 1 1 1 1 1 1 7 11 18 16 16 16 16 16 16 16 16 16 16 16 16 16 16 16 16 16 16 16 16 16 16 16 16 16 16 16 16 16 16 16 20 11 8 1 1 1 1 1 1 1 1 7 11 17 17 17 17 17 17 17 17 17 17 17 17 17 17 17 17 17 17 17 17 17 17 17 17 17 17 17 17 17 17 17 17 17 11 8 1 1 1 1 1 1 1 1 1
1 1 1 1 1 1 1 1 1 7 11 14 19 19 19 19 19 19 19 19 19 19 19 19 19 19 19 19 19 19 19 19 19 19 19 19 19 19 19 19 19 19 19 15 11 8 1 1 1 1 1 1 1 1 7 11 17 17 17 17 17 17 17 17 17 17 17 17 17 17 17 17 17 17 17 17 17 17 17 17 17 17 17 17 17 17 17 17 17 11 8 1 1 1 1 1 1 1 1 1
1 1 1 1 1 1 1 1 1 7 11 17 17 17 17 17 17 17 17 17 17 17 17 17 17 17 17 17 17 17 17 17 17 17 17 17 17 17 17 17 17 17 17 17 11 8 1 1 1 1 1 1 1 1 7 11 17 17 17 17 17 17 17 17 17 17 17 17 17 17 17 17 17 17 17 17 17 17 17 17 17 17 17 17 17 17 17 17 17 11 8 1 1 1 1 1 1 1 1 1
1 1 1 1 1 1 1 1 1 7 11 11 11 11 11 11 11 11 11 11 11 11 11 11 11 10 10 10 10 10 11 11 11 11 11 11 11 11 11 11 11 11 11 11 11 30 6 6 6 6 6 6 6 6 31 11 11 11 11 11 11 11 11 11 11 11 11 11 11 11 10 10 10 10 10 11 11 11 11 11 11 11 11 11 11 11 11 11 11 11 8 1 1 1 1 1 1 1 1 1
1 1 1 1 1 1 1 1 1 4 9 9 9 9 9 9 9 9 9 9 9 9 9 9 9 10 10 10 10 10 9 9 9 9 9 9 9 9 9 9 9 9 9 9 32 17 17 17 17 17 17 17 17 17 17 33 9 9 9 9 9 9 9 9 9 9 9 9 9 9 10 10 10 10 10 9 9 9 9 9 9 9 9 9 9 9 9 9 9 9 5 1 1 1 1 1 1 1 1 1
1 1 1 1 1 1 1 1 1 1 1 1 1 1 1 1 1 1 1 1 1 1 1 1 1 10 10 10 10 10 1 1 1 1 1 1 1 1 1 1 1 1 1 1 7 17 17 17 17 17 17 17 17 17 17 8 1 1 1 1 1 1 1 1 1 1 1 1 1 1 10 10 10 10 10 1 1 1 1 1 1 1 1 1 1 1 1 1 1 1 1 1 1 1 1 1 1 1 1 1
26 26 26 26 26 26 26 26 26 26 26 26 26 26 26 26 26 26 26 26 26 26 26 26 26 10 10 10 10 10 26 26 26 26 26 26 26 26 26 26 26 26 26 26 7 17 17 17 17 17 17 17 17 17 17 8 26 26 26 26 26 26 26 26 26 26 26 26 26 26 10 10 10 10 10 26 26 26 26 26 26 26 26 26 26 26 26 26 26 26 26 26 26 26 26 26 26 26 26 26
27 27 27 27 27 27 27 27 27 27 27 27 27 27 27 27 27 27 27 27 27 27 27 27 27 10 10 10 10 10 10 10 10 10 10 10 10 10 10 10 10 10 10 10 10 17 17 17 17 17 17 17 17 17 17 8 27 27 27 27 27 27 27 27 27 27 27 27 27 27 10 10 10 10 10 27 27 27 27 27 27 27 27 27 27 27 27 27 27 27 27 27 27 27 27 27 27 27 27 27
27 27 27 27 27 27 27 27 27 27 27 27 27 27 27 27 27 27 27 27 27 27 27 27 27 10 10 10 10 10 10 10 10 10 10 10 10 10 10 10 10 10 10 10 10 17 17 17 17 17 17 17 17 17 17 8 27 27 27 27 27 27 27 27 27 27 27 27 27 27 10 10 10 10 10 27 27 27 27 27 27 27 27 27 27 27 27 27 27 27 27 27 27 27 27 27 27 27 27 27
27 27 27 27 27 27 27 27 27 27 27 27 27 27 27 27 27 27 27 27 27 27 27 27 27 10 10 10 10 10 10 10 10 10 10 10 10 10 10 10 10 10 10 10 10 17 17 17 17 17 17 17 17 17 17 8 27 27 27 27 27 27 27 27 27 27 27 27 27 27 10 10 10 10 10 27 27 27 27 27 27 27 27 27 27 27 27 27 27 27 27 27 27 27 27 27 27 27 27 27
27 27 27 27 27 27 27 27 27 27 27 27 27 27 27 27 27 27 27 27 27 27 27 27 27 29 29 29 29 29 29 29 29 29 29 29 29 29 29 29 29 29 29 29 7 17 17 17 17 17 17 17 17 17 17 8 27 27 27 27 27 27 27 27 27 27 27 27 27 27 10 10 10 10 10 27 27 27 27 27 27 27 27 27 27 27 27 27 27 27 27 27 27 27 27 27 27 27 27 27
28 28 28 28 28 28 28 28 28 28 28 28 28 28 28 28 28 28 28 28 28 28 28 28 28 28 28 28 28 28 28 28 28 28 28 28 28 28 28 28 28 28 28 28 7 17 17 17 17 17 17 17 17 17 17 8 28 28 28 28 28 28 28 28 28 28 28 28 28 28 10 10 10 10 10 28 28 28 28 28 28 28 28 28 28 28 28 28 28 28 28 28 28 28 28 28 28 28 28 28
1 1 1 1 1 1 1 1 1 1 1 1 1 1 1 1 1 1 1 1 1 1 1 1 1 1 1 1 1 1 1 1 1 1 1 1 1 1 1 1 1 1 1 1 7 17 17 17 17 17 17 17 17 17 17 8 1 1 1 1 1 1 1 1 1 1 1 1 1 1 10 10 10 10 10 1 1 1 1 1 1 1 1 1 1 1 1 1 1 1 1 1 1 1 1 1 1 1 1 1
1 1 1 1 1 1 1 1 1 2 6 6 6 6 6 6 6 6 6 6 6 6 6 6 6 6 6 6 6 6 6 6 6 6 6 6 6 6 6 6 6 6 6 6 31 17 17 17 17 17 17 17 17 17 17 30 6 6 6 6 6 6 6 6 6 6 6 6 6 6 10 10 10 10 10 6 6 6 6 6 6 6 6 6 6 6 6 6 6 6 3 1 1 1 1 1 1 1 1 1
1 1 1 1 1 1 1 1 1 7 11 11 11 11 11 11 11 11 11 11 11 11 11 11 11 11 11 11 11 11 11 11 11 11 11 11 11 11 11 11 11 11 11 11 11 33 9 9 9 9 9 9 9 9 32 11 11 11 11 11 11 11 11 11 11 11 11 11 11 11 10 10 10 10 10 11 11 11 11 11 11 11 11 11 11 11 11 11 11 11 8 1 1 1 1 1 1 1 1 1
1 1 1 1 1 1 1 1 1 7 11 12 21 21 21 21 21 21 21 21 21 21 21 21 21 21 21 21 21 21 21 21 21 21 21 21 21 21 21 21 21 21 21 13 11 8 1 1 1 1 1 1 1 1 7 11 12 21 21 21 21 21 21 21 21 21 21 21 21 13 17 17 17 17 17 17 17 17 17 17 17 17 17 17 17 17 17 17 17 11 8 1 1 1 1 1 1 1 1 1
1 1 1 1 1 1 1 1 1 7 11 18 16 16 16 16 16 16 16 16 16 16 16 16 16 16 16 16 16 16 16 16 16 16 16 16 16 16 16 16 16 16 16 20 11 8 1 1 1 1 1 1 1 1 7 11 18 16 16 16 16 16 16 16 16 16 16 16 16 20 17 17 17 17 17 17 17 17 17 17 17 17 17 17 17 17 17 17 17 11 8 1 1 1 1 1 1 1 1 1
1 1 1 1 1 1 1 1 1 7 11 18 16 16 16 16 16 16 16 16 16 16 16 16 16 16 16 16 16 16 16 16 16 16 16 16 16 16 16 16 16 16 16 20 11 8 1 1 1 1 1 1 1 1 7 11 18 16 16 16 16 16 16 16 16 16 16 16 16 20 17 17 17 17 17 17 17 17 17 17 17 17 17 17 17 17 17 17 17 11 8 1 1 1 1 1 1 1 1 1
1 1 1 1 1 1 1 1 1 7 11 18 16 16 16 16 16 16 16 16 16 16 16 16 16 16 16 16 16 16 16 16 16 16 16 16 16 16 16 16 16 16 16 20 11 8 1 1 1 1 1 1 1 1 7 11 18 16 16 16 16 16 16 16 16 16 16 16 16 20 17 17 17 17 17 17 17 17 17 17 17 17 17 17 17 17 17 17 17 11 8 1 1 1 1 1 1 1 1 1
1 1 1 1 1 1 1 1 1 7 11 18 16 16 16 16 16 16 16 16 16 16 16 16 16 16 16 16 16 16 16 16 16 16 16 16 16 16 16 16 16 16 16 20 11 8 1 1 1 1 1 1 1 1 7 11 18 16 16 16 16 16 16 16 16 16 16 16 16 20 17 17 17 17 17 17 17 17 17 17 17 17 17 17 17 17 17 17 17 11 8 1 1 1 1 1 1 1 1 1
1 1 1 1 1 1 1 1 1 7 11 18 16 16 16 16 16 16 16 16 16 16 16 16 16 16 16 16 16 16 16 16 16 16 16 16 16 16 16 16 16 16 16 20 11 8 1 1 1 1 1 1 1 1 7 11 18 16 16 16 16 16 16 16 16 16 16 16 16 20 17 17 17 17 17 17 17 17 17 17 17 17 17 17 17 17 17 17 17 11 8 1 1 1 1 1 1 1 1 1
1 1 1 1 1 1 1 1 1 7 11 18 16 16 16 16 16 16 16 16 16 16 16 16 16 16 16 16 16 16 16 16 16 16 16 16 16 16 16 16 16 16 16 20 11 8 1 1 1 1 1 1 1 1 7 11 18 16 16 16 16 16 16 16 16 22 19 19 19 15 17 17 17 17 17 17 17 17 17 17 17 17 17 17 17 17 17 17 17 11 8 1 1 1 1 1 1 1 1 1
1 1 1 1 1 1 1 1 1 7 11 18 16 16 16 16 16 16 16 16 16 16 16 16 16 16 16 16 16 16 16 16 16 16 16 16 16 16 16 16 16 16 16 20 11 8 1 1 1 1 1 1 1 1 7 11 18 16 16 16 16 16 16 16 16 20 17 17 17 17 17 17 17 17 17 17 17 17 17 17 17 17 17 17 17 17 17 17 17 11 8 1 1 1 1 1 1 1 1 1
1 1 1 1 1 1 1 1 1 7 11 18 16 16 16 16 16 16 16 16 16 16 16 16 16 16 16 16 16 16 16 16 16 16 16 16 16 16 16 16 16 16 16 20 11 8 1 1 1 1 1 1 1 1 7 11 18 16 16 16 16 16 16 16 16 20 17 17 17 17 17 17 17 17 17 17 17 17 17 17 17 17 17 17 17 17 17 17 17 11 8 1 1 1 1 1 1 1 1 1
1 1 1 1 1 1 1 1 1 7 11 18 16 16 16 16 16 16 16 16 16 16 16 16 16 16 16 16 16 16 16 16 16 16 16 16 16 16 16 16 16 16 16 20 11 8 1 1 1 1 1 1 1 1 7 11 18 16 16 16 16 16 22 19 19 15 17 17 17 17 17 17 17 17 17 17 17 17 17 17 17 17 17 17 17 17 17 17 17 11 8 1 1 1 1 1 1 1 1 1
1 1 1 1 1 1 1 1 1 7 11 18 16 16 16 16 16 16 16 16 16 16 16 16 16 16 16 16 16 16 16 16 16 16 16 16 16 16 16 16 16 16 16 20 11 8 1 1 1 1 1 1 1 1 7 11 18 16 16 16 16 16 20 17 17 17 17 17 17 17 17 17 17 17 17 17 17 17 17 17 17 17 17 17 17 17 17 17 17 11 8 1 1 1 1 1 1 1 1 1
1 1 1 1 1 1 1 1 1 7 11 18 16 16 16 16 16 16 16 16 16 16 16 16 16 16 16 16 16 16 16 16 16 16 16 16 16 16 16 16 16 16 16 20 11 8 1 1 1 1 1 1 1 1 7 11 18 16 16 16 16 16 20 17 17 17 17 17 17 17 17 17 17 17 17 17 17 17 17 17 17 17 17 17 17 17 17 17 17 11 8 1 1 1 1 1 1 1 1 1
1 1 1 1 1 1 1 1 1 7 11 18 16 16 16 16 16 16 16 16 16 16 16 16 16 16 16 16 16 16 16 16 16 16 16 16 16 16 16 16 16 16 16 20 11 8 1 1 1 1 1 1 1 1 7 11 18 16 16 16 16 16 20 17 17 17 17 17 17 17 17 17 17 17 17 17 17 17 17 17 17 17 17 17 17 17 17 17 17 11 8 1 1 1 1 1 1 1 1 1
1 1 1 1 1 1 1 1 1 7 11 18 16 16 16 16 16 16 16 16 16 16 16 16 16 16 16 16 16 16 16 16 16 16 16 16 16 16 16 16 16 16 16 20 11 8 1 1 1 1 1 1 1 1 7 11 14 19 19 19 19 19 15 17 17 17 17 17 17 17 17 17 17 17 17 17 17 17 17 17 17 17 17 17 17 17 17 17 17 11 8 1 1 1 1 1 1 1 1 1
1 1 1 1 1 1 1 1 1 7 11 18 16 16 16 16 16 16 16 16 16 16 16 16 16 16 16 16 16 16 16 16 16 16 16 16 16 16 16 16 16 16 16 20 10 10 10 10 10 10 10 10 10 10 10 10 17 17 17 17 17 17 17 17 17 17 17 17 17 17 17 17 17 17 17 17 17 17 17 17 17 17 17 17 17 17 17 17 17 11 8 1 1 1 1 1 1 1 1 1
1 1 1 1 1 1 1 1 1 7 11 18 16 16 16 16 16 16 16 16 16 16 16 16 16 16 16 16 16 16 16 16 16 16 16 16 16 16 16 16 16 16 16 20 10 10 10 10 10 10 10 10 10 10 10 10 17 17 17 17 17 17 17 17 17 17 17 17 17 17 17 17 17 17 17 17 17 17 17 17 17 17 17 17 17 17 17 17 17 11 8 1 1 1 1 1 1 1 1 1
1 1 1 1 1 1 1 1 1 7 11 18 16 16 16 16 16 16 16 16 16 16 16 16 16 16 16 16 16 16 16 16 16 16 16 16 16 16 16 16 16 16 16 20 10 10 10 10 10 10 10 10 10 10 10 10 17 17 17 17 17 17 17 17 17 17 17 17 17 17 17 17 17 17 17 17 17 17 17 17 17 17 17 17 17 17 17 17 17 11 8 1 1 1 1 1 1 1 1 1
1 1 1 1 1 1 1 1 1 7 11 18 16 16 16 16 16 16 16 16 16 16 16 16 16 16 16 16 16 16 16 16 16 16 16 16 16 16 16 16 16 16 16 20 10 10 10 10 10 10 10 10 10 10 10 10 17 17 17 17 17 17 17 17 17 17 17 17 17 17 17 17 17 17 17 17 17 17 17 17 17 17 17 17 17 17 17 17 17 11 8 1 1 1 1 1 1 1 1 1
1 1 1 1 1 1 1 1 1 7 11 18 16 16 16 16 16 16 16 16 16 16 16 16 16 16 16 16 16 16 16 16 16 16 16 16 16 16 16 16 16 16 16 20 10 10 10 10 10 10 10 10 10 10 10 10 17 17 17 17 17 17 17 17 17 17 17 17 17 17 17 17 17 17 17 17 17 17 17 17 17 17 17 17 17 17 17 17 17 11 8 1 1 1 1 1 1 1 1 1
1 1 1 1 1 1 1 1 1 7 11 18 16 16 16 16 16 16 16 16 16 16 16 16 16 16 16 16 16 16 16 16 16 16 16 16 16 16 16 16 16 16 16 20 11 8 29 29 29 29 29 29 29 29 7 11 17 17 17 17 17 17 17 17 17 17 17 17 17 17 17 17 17 17 17 17 17 17 17 17 17 17 17 17 17 17 17 17 17 11 8 1 1 1 1 1 1 1 1 1
1 1 1 1 1 1 1 1 1 7 11 18 16 16 16 16 16 16 16 16 16 16 16 16 16 16 16 16 16 16 16 16 16 16 16 16 16 16 16 16 16 16 16 20 11 8 1 1 1 1 1 1 1 1 7 11 12 21 21 21 21 21 21 21 21 21 21 21 21 21 21 21 21 21 21 21 21 21 21 21 21 21 21 21 21 21 21 21 13 11 8 1 1 1 1 1 1 1 1 1
1 1 1 1 1 1 1 1 1 7 11 18 16 16 16 16 16 16 16 16 16 16 16 16 16 16 16 16 16 16 16 16 16 16 16 16 16 16 16 16 16 16 16 20 11 8 1 1 1 1 1 1 1 1 7 11 18 16 16 16 16 16 16 16 16 16 16 16 16 16 16 16 16 16 16 16 16 16 16 16 16 16 16 16 16 16 16 16 20 11 8 1 1 1 1 1 1 1 1 1
1 1 1 1 1 1 1 1 1 7 11 18 16 16 16 16 16 16 16 16 16 16 16 16 16 16 16 16 16 16 16 16 16 16 16 16 16 16 16 16 16 16 16 20 11 8 1 1 1 1 1 1 1 1 7 11 18 16 16 16 16 16 16 16 16 16 16 16 16 16 16 16 16 16 16 16 16 16 16 16 16 16 16 16 16 16 16 16 20 11 8 1 1 1 1 1 1 1 1 1
1 1 1 1 1 1 1 1 1 7 11 18 16 16 16 16 16 16 16 16 16 16 16 16 16 16 16 16 16 16 16 16 16 16 16 16 16 16 16 16 16 16 16 20 11 8 1 1 1 1 1 1 1 1 7 11 18 16 16 16 16 16 16 16 16 16 16 16 16 16 16 16 16 16 16 16 16 16 16 16 16 16 16 16 16 16 16 16 20 11 8 1 1 1 1 1 1 1 1 1
1 1 1 1 1 1 1 1 1 7 11 18 16 16 16 16 16 16 16 16 16 16 16 16 16 16 16 16 16 16 16 16 16 16 16 16 16 16 16 16 16 16 16 20 11 8 1 1 1 1 1 1 1 1 7 11 18 16 16 16 16 16 16 16 16 16 16 16 16 16 16 16 16 16 16 16 16 16 16 16 16 16 16 16 16 16 16 16 20 11 8 1 1 1 1 1 1 1 1 1
1 1 1 1 1 1 1 1 1 7 11 18 16 16 16 16 16 16 16 16 16 16 16 16 16 16 16 16 16 16 16 16 16 16 16 16 16 16 16 16 16 16 16 20 11 8 1 1 1 1 1 1 1 1 7 11 18 16 16 16 16 16 16 16 16 16 16 16 16 16 16 16 16 16 16 16 16 16 16 16 16 16 16 16 16 16 16 16 20 11 8 1 1 1 1 1 1 1 1 1
1 1 1 1 1 1 1 1 1 7 11 18 16 16 16 16 16 16 16 16 16 16 16 16 16 16 16 16 16 16 16 16 16 16 16 16 16 16 16 16 16 16 16 20 11 8 1 1 1 1 1 1 1 1 7 11 18 16 16 16 16 16 16 16 16 16 16 16 16 16 16 16 16 16 16 16 16 16 16 16 16 16 16 16 16 16 16 16 20 11 8 1 1 1 1 1 1 1 1 1
1 1 1 1 1 1 1 1 1 7 11 18 16 16 16 16 16 16 16 16 16 16 16 16 16 16 16 16 16 16 16 16 16 16 16 16 16 16 16 16 16 16 16 20 11 8 1 1 1 1 1 1 1 1 7 11 18 16 16 16 16 16 16 16 16 16 16 16 16 16 16 16 16 16 16 16 16 16 16 16 16 16 16 16 16 16 16 16 20 11 8 1 1 1 1 1 1 1 1 1
1 1 1 1 1 1 1 1 1 7 11 18 16 16 16 16 16 16 16 16 16 16 16 16 16 16 16 16 16 16 16 16 16 16 16 16 16 16 16 16 16 16 16 20 11 8 1 1 1 1 1 1 1 1 7 11 18 16 16 16 16 16 16 16 16 16 16 16 16 16 16 16 16 16 16 16 16 16 16 16 16 16 16 16 16 16 16 16 20 11 8 1 1 1 1 1 1 1 1 1
1 1 1 1 1 1 1 1 1 7 11 18 16 16 16 16 16 16 16 16 16 16 16 16 16 16 16 16 16 16 16 16 16 16 16 16 16 16 16 16 16 16 16 20 11 8 1 1 1 1 1 1 1 1 7 11 18 16 16 16 16 16 16 16 16 16 16 16 16 16 16 16 16 16 16 16 16 16 16 16 16 16 16 16 16 16 16 16 20 11 8 1 1 1 1 1 1 1 1 1
1 1 1 1 1 1 1 1 1 7 11 18 16 16 16 16 16 16 16 16 16 16 16 16 16 16 16 16 16 16 16 16 16 16 16 16 16 16 16 16 16 16 16 20 11 8 1 1 1 1 1 1 1 1 7 11 18 16 16 16 16 16 16 16 16 16 16 16 16 16 16 16 16 16 16 16 16 16 16 16 16 16 16 16 16 16 16 16 20 11 8 1 1 1 1 1 1 1 1 1
1 1 1 1 1 1 1 1 1 7 11 18 16 16 16 16 16 16 16 16 16 16 16 16 16 16 16 16 16 16 16 16 16 16 16 16 16 16 16 16 16 16 16 20 11 8 1 1 1 1 1 1 1 1 7 11 18 16 16 16 16 16 16 16 16 16 16 16 16 16 16 16 16 16 16 16 16 16 16 16 16 16 16 16 16 16 16 16 20 11 8 1 1 1 1 1 1 1 1 1
1 1 1 1 1 1 1 1 1 7 11 14 19 19 19 19 19 19 19 19 19 19 19 19 19 19 19 19 19 19 19 19 19 19 19 19 19 19 19 19 19 19 19 15 11 8 1 1 1 1 1 1 1 1 7 11 14 19 19 19 19 19 19 19 19 19 19 19 19 19 19 19 19 19 19 19 19 19 19 19 19 19 19 19 19 19 19 19 15 11 8 1 1 1 1 1 1 1 1 1
1 1 1 1 1 1 1 1 1 7 11 11 11 11 11 11 11 11 11 11 11 11 11 11 11 11 11 11 11 11 11 11 11 11 11 11 11 11 11 11 11 11 11 11 11 8 1 1 1 1 1 1 1 1 7 11 11 11 11 11 11 11 11 11 11 11 11 11 11 11 11 11 11 11 11 11 11 11 11 11 11 11 11 11 11 11 11 11 11 11 8 1 1 1 1 1 1 1 1 1
1 1 1 1 1 1 1 1 1 4 9 9 9 9 9 9 9 9 9 9 9 9 9 9 9 9 9 9 9 9 9 9 9 9 9 9 9 9 9 9 9 9 9 9 9 5 1 1 1 1 1 1 1 1 4 9 9 9 9 9 9 9 9 9 9 9 9 9 9 9 9 9 9 9 9 9 9 9 9 9 9 9 9 9 9 9 9 9 9 9 5 1 1 1 1 1 1 1 1 1
1 1 1 1 1 1 1 1 1 1 1 1 1 1 1 1 1 1 1 1 1 1 1 1 1 1 1 1 1 1 1 1 1 1 1 1 1 1 1 1 1 1 1 1 1 1 1 1 1 1 1 1 1 1 1 1 1 1 1 1 1 1 1 1 1 1 1 1 1 1 1 1 1 1 1 1 1 1 1 1 1 1 1 1 1 1 1 1 1 1 1 1 1 1 1 1 1 1 1 1
1 1 1 1 1 1 1 1 1 1 1 1 1 1 1 1 1 1 1 1 1 1 1 1 1 1 1 1 1 1 1 1 1 1 1 1 1 1 1 1 1 1 1 1 1 1 1 1 1 1 1 1 1 1 1 1 1 1 1 1 1 1 1 1 1 1 1 1 1 1 1 1 1 1 1 1 1 1 1 1 1 1 1 1 1 1 1 1 1 1 1 1 1 1 1 1 1 1 1 1
1 1 1 1 1 1 1 1 1 1 1 1 1 1 1 1 1 1 1 1 1 1 1 1 1 1 1 1 1 1 1 1 1 1 1 1 1 1 1 1 1 1 1 1 1 1 1 1 1 1 1 1 1 1 1 1 1 1 1 1 1 1 1 1 1 1 1 1 1 1 1 1 1 1 1 1 1 1 1 1 1 1 1 1 1 1 1 1 1 1 1 1 1 1 1 1 1 1 1 1
1 1 1 1 1 1 1 1 1 1 1 1 1 1 1 1 1 1 1 1 1 1 1 1 1 1 1 1 1 1 1 1 1 1 1 1 1 1 1 1 1 1 1 1 1 1 1 1 1 1 1 1 1 1 1 1 1 1 1 1 1 1 1 1 1 1 1 1 1 1 1 1 1 1 1 1 1 1 1 1 1 1 1 1 1 1 1 1 1 1 1 1 1 1 1 1 1 1 1 1
1 1 1 1 1 1 1 1 1 1 1 1 1 1 1 1 1 1 1 1 1 1 1 1 1 1 1 1 1 1 1 1 1 1 1 1 1 1 1 1 1 1 1 1 1 1 1 1 1 1 1 1 1 1 1 1 1 1 1 1 1 1 1 1 1 1 1 1 1 1 1 1 1 1 1 1 1 1 1 1 1 1 1 1 1 1 1 1 1 1 1 1 1 1 1 1 1 1 1 1
1 1 1 1 1 1 1 1 1 1 1 1 1 1 1 1 1 1 1 1 1 1 1 1 1 1 1 1 1 1 1 1 1 1 1 1 1 1 1 1 1 1 1 1 1 1 1 1 1 1 1 1 1 1 1 1 1 1 1 1 1 1 1 1 1 1 1 1 1 1 1 1 1 1 1 1 1 1 1 1 1 1 1 1 1 1 1 1 1 1 1 1 1 1 1 1 1 1 1 1
1 1 1 1 1 1 1 1 1 1 1 1 1 1 1 1 1 1 1 1 1 1 1 1 1 1 1 1 1 1 1 1 1 1 1 1 1 1 1 1 1 1 1 1 1 1 1 1 1 1 1 1 1 1 1 1 1 1 1 1 1 1 1 1 1 1 1 1 1 1 1 1 1 1 1 1 1 1 1 1 1 1 1 1 1 1 1 1 1 1 1 1 1 1 1 1 1 1 1 1
1 1 1 1 1 1 1 1 1 1 1 1 1 1 1 1 1 1 1 1 1 1 1 1 1 1 1 1 1 1 1 1 1 1 1 1 1 1 1 1 1 1 1 1 1 1 1 1 1 1 1 1 1 1 1 1 1 1 1 1 1 1 1 1 1 1 1 1 1 1 1 1 1 1 1 1 1 1 1 1 1 1 1 1 1 1 1 1 1 1 1 1 1 1 1 1 1 1 1 1
1 1 1 1 1 1 1 1 1 1 1 1 1 1 1 1 1 1 1 1 1 1 1 1 1 1 1 1 1 1 1 1 1 1 1 1 1 1 1 1 1 1 1 1 1 1 1 1 1 1 1 1 1 1 1 1 1 1 1 1 1 1 1 1 1 1 1 1 1 1 1 1 1 1 1 1 1 1 1 1 1 1 1 1 1 1 1 1 1 1 1 1 1 1 1 1 1 1 1 1